NO ./textures/north.xpm
SO ./textures/south.xpm
WE ./textures/west.xpm
EA ./textures/east.xpm
DO ./textures/east.xpm
F 220,100,0
C 225,30,0

1111111
10D0001
10000N1
100 001
1111111