NO assets/grass.xpm
SO assets/grass.xpm
WE assets/grass.xpm
DO assets/grass.xpm
EA assets/grasss.xpm

F 0, 0, 0
C 0, 0, 0

        1111111111111111111111111
        1000000000110000000000001
        1011000001110000000000001
        1001000000000000000000001
111111111011000001110000000000001
100000000011000001110111111111111
11110111111111011100000010001
1111D111111111011101010010001
11000000110101011100000010001
10000000000000001100000010001
10000000000000001101010000001
11000001110101011111011110N0111
1111011111101010101111010001
11111111111111111111111111111