NO n.xpm
SO s.xpm
WE w.xpm
EA e.xpm
DO e.xpm
F 300,0,0
C 255,255,255

111111
1000N1
1D0001
111111