SO assets/wood.xpm
NO assets/wood.xpm
WE assets/wood.xpm
EA assets/wood.xpm
DO assets/door.xpm

F 0,0,0
C 255,255,255

111111
1000N1
1D00S1
111111