1111111111
10000000C1
10P0001111
1000000001
1000110001
11111E1001
1000000001
1C11000101
11C0000101
1111111111
1111111111