11111111111111111111
11100000100000000C11
11000000000000100001
100C1111111011011111
1001C001000000000001
100P1010011111001001
1111100000010C010001
1E00001C000100010C11
11111111111111111111
