111111111111111111
10000000000000C0P1
100011100000001111
10C11C10D110010DE1
10D110001110D11001
100011111C1C110001
10000000D011100001
100000000000000001
111111111111111111
