NO assets/tests/no.xpm
SO assets/tests/so.xpm
WE assets/tests/we.xpm
EA assets/tests/ea.xpm

F 242, 222, 136
C 97, 182, 242

11111111111111 111111111
100000000100001000000001
10000000000000000000011
100000000000000000000001
100000000000000000000001
100000001110000000000001
100000001  10000000000001
100000001110000S00000001
100000000000000000000001
100000000000100000000001
100000000001 10000000001
100000000000100000000001
100000000000000000010001
1000000000000000001 1001
1111111111111111111 1111