NO n.xpm
SO s.xpm
WE w.xpm
EA e.xpm
F 1,1,1
C 10,10,255

111111
100001
1000N0
100001
111101