11111111
1P000001
10000001
1110C111
10000001
1E000001
11111111
