1111111
1P000C1
1110111
1D000E1
1111111