1111111111111
1P0010010D011
100011001C101
10C0111100001
111001E111001
10000D0D10001
1000000110001
110DC1110C1D1
1100000000001
1111111111111