111111111111111111111111111111
100000000000100000D000001000C1
100001000100100000000000100001
1000100D11001000001000000100D1
100100011110010011110000000111
1001E0010010C1C1C00D1000000001
1001111100C1100010001000000011
1001000D000010P0100011100001C1
100000000111100010000001100101
10011101100001110000100000D001
1001C00000D0000000011111000001
111111111111111111111111111111
