11111111011111111111
11100000000000000011
11000000000000100001
10001111111011011111
10010001C00000000001
100P1010011111001001
11111000000100010001
1E000010000100010011
11111111111111111111
